TILEMAP
200 15 								-- Size of tile map in tiles
16 16 								-- Tile size & block size
images/clouds.png 						-- Tilesheet
5 11  								-- Number of tiles in tilesheet
0 0 0 0 0 0 0 0 0 0 0 0 0 0 0 0 0 0 0 0 0 0 0 0 0 0 0 0 0 0 0 0 0 0 0 0 0 0 0 0 0 0 0 0 0 0 0 0 0 0 0 0 0 0 0 0 0 0 0 0 0 0 0 0 0 0 0 0 0 0 0 0 0 0 0 0 0 0 0 0 0 0 0 0 0 0 0 0 0 0 0 0 0 0 0 0 21 14 0 14 0 0 0 0 0 0 0 0 0 0 0 0 0 0 0 0 0 0 0 0 0 0 0 0 0 0 0 0 0 0 0 0 52 42 42 0 0 0 0 0 0 0 0 0 0 0 0 0 0 0 0 0 0 0 0 0 0 0 0 0 0 0 0 0 0 0 0 0 0 0 0 0 0 0 0 0 0 0 0 0 0 0 0 0 0 0 0 0 0 0 0 0 0 0 0 0 0 0 0 0 
0 5 7 7 7 6 6 7 7 6 7 6 7 6 6 7 6 7 0 28 17 6 7 7 7 7 6 6 7 7 6 7 7 6 7 6 7 6 7 7 6 7 6 6 6 6 6 6 6 6 6 7 6 7 7 6 7 7 6 7 7 6 6 6 6 7 6 6 6 6 7 7 7 7 7 7 7 6 7 6 7 6 7 7 6 7 6 7 7 7 7 7 6 6 6 7 6 7 0 0 4 8 9 4 9 3 9 8 9 4 3 3 9 8 9 8 4 8 8 3 8 8 8 4 4 9 9 8 4 27 52 0 47 52 52 52 31 42 28 4 4 3 4 4 4 4 4 3 4 3 3 4 26 0 0 0 0 0 0 0 0 0 0 0 0 0 0 0 0 0 0 0 0 0 0 0 28 4 4 4 3 3 4 3 3 4 4 4 3 3 3 4 4 4 3 4 3 3 27 0 
0 29 0 0 0 0 0 0 0 0 0 0 0 0 0 0 0 27 0 28 0 0 0 0 0 0 0 0 0 0 0 0 0 0 0 0 0 0 0 0 0 0 0 0 0 0 0 0 0 0 0 0 0 0 0 0 0 0 0 0 0 0 0 0 0 0 0 0 0 0 0 0 0 0 0 0 0 0 0 0 0 0 0 0 0 0 0 0 0 0 0 0 0 0 0 0 0 0 0 0 0 0 0 0 0 0 0 0 0 0 0 0 0 0 0 0 0 0 0 0 0 0 0 0 0 0 0 0 0 26 42 31 31 0 0 47 47 47 29 0 0 0 0 0 0 0 0 0 0 0 0 0 27 0 0 0 0 0 0 0 12 1 2 1 2 2 2 2 2 2 11 0 0 0 0 0 29 0 0 0 0 0 0 0 0 0 0 0 0 0 0 0 0 0 0 0 0 0 27 0 
0 28 0 0 0 0 0 0 0 0 0 0 0 0 0 0 0 26 0 29 0 0 0 0 0 0 0 0 0 0 0 0 0 0 0 0 0 0 0 0 0 0 0 0 0 0 0 0 0 0 0 0 0 0 0 0 0 0 0 0 0 0 0 0 0 0 0 0 0 0 0 0 0 0 0 0 0 0 0 0 0 0 0 0 0 0 0 0 0 0 0 0 0 0 0 0 0 0 0 0 0 0 0 0 0 12 2 2 1 1 2 1 2 1 2 11 0 0 0 0 0 0 0 0 0 0 0 0 0 27 42 7 7 6 6 7 7 51 28 0 0 0 0 0 0 0 0 0 0 0 0 0 26 0 0 0 0 0 0 0 0 0 0 0 0 0 0 0 0 7 16 0 0 0 0 0 28 0 0 0 0 0 0 0 0 0 0 0 0 0 0 0 0 0 0 0 0 0 27 0 
0 28 0 0 0 0 0 0 0 0 0 0 0 0 0 0 0 26 0 28 0 0 0 0 0 0 0 0 0 0 0 0 0 0 0 0 0 0 0 0 0 0 0 0 0 0 0 0 0 0 0 0 0 0 12 1 2 1 1 2 1 1 1 2 2 2 1 1 11 0 0 0 0 0 0 0 0 0 0 0 0 0 0 0 0 0 0 0 0 0 0 0 0 0 0 0 0 0 31 0 0 0 0 0 0 26 31 0 0 0 0 0 0 0 0 28 0 0 0 0 0 0 0 0 0 0 0 0 0 26 0 0 0 0 0 0 0 0 29 0 0 0 12 1 2 1 2 1 1 1 11 0 27 0 0 0 0 0 0 0 0 0 0 0 0 0 0 0 0 0 0 0 0 0 0 0 28 0 0 0 0 0 0 0 0 0 0 0 0 0 0 0 0 0 0 0 0 0 27 0 
0 28 0 0 0 0 0 0 0 0 0 0 0 0 0 0 0 27 0 29 0 0 0 0 0 0 0 0 0 0 0 0 0 0 0 0 0 0 0 0 0 0 0 0 0 0 0 0 0 0 0 0 0 0 0 0 0 0 0 0 0 0 0 0 0 0 0 0 0 0 0 0 0 0 0 0 0 0 0 0 0 0 0 0 0 0 0 0 0 0 0 0 0 0 0 0 0 0 0 0 0 0 0 0 0 26 0 5 3 4 3 4 3 26 0 28 0 0 0 0 0 0 0 0 0 0 0 0 0 27 42 2 1 2 1 2 2 42 29 0 0 0 27 0 0 0 0 0 0 0 28 0 26 0 0 0 0 0 0 0 0 0 0 0 0 0 0 0 0 0 0 0 0 0 0 0 29 0 0 0 0 0 0 0 0 0 0 0 0 0 50 0 0 0 0 0 0 0 27 0 
0 28 0 0 0 0 0 0 0 0 0 0 0 0 0 0 0 27 0 29 0 0 0 0 0 0 0 0 0 0 0 0 0 0 0 0 0 0 0 0 0 0 0 0 0 0 0 0 0 0 0 0 0 0 0 0 0 0 0 0 0 0 0 0 0 0 0 0 0 0 0 0 0 0 0 0 0 0 0 0 0 0 0 0 0 0 0 0 0 0 0 0 0 0 0 0 0 0 0 0 0 0 0 0 0 26 0 28 0 0 0 0 0 27 0 28 0 0 0 0 0 0 0 0 0 0 0 0 0 27 42 51 52 52 36 42 42 51 29 0 0 0 27 0 0 0 0 0 0 0 28 0 27 0 0 0 0 0 0 0 0 0 0 0 0 0 0 0 0 0 0 0 0 0 0 0 28 0 0 0 0 0 0 0 12 2 1 1 1 2 55 1 1 1 1 11 0 0 27 0 
0 24 2 1 2 1 2 1 2 1 2 1 2 11 0 0 0 27 0 28 0 0 0 0 0 0 0 0 0 0 0 0 0 12 1 2 2 1 1 2 1 11 0 0 0 0 0 0 0 0 0 0 0 0 0 0 0 0 0 0 0 0 0 0 0 0 0 0 0 0 0 0 0 0 0 0 0 0 0 0 0 0 0 0 0 0 0 0 0 0 0 0 0 0 0 0 0 0 0 0 0 0 0 0 0 26 31 28 0 0 0 0 0 26 31 28 0 0 0 0 0 0 0 0 0 0 0 0 0 26 51 47 31 0 0 36 42 51 28 0 0 0 17 7 6 6 6 7 7 0 28 0 17 7 7 6 7 7 6 6 6 7 6 7 7 7 7 7 7 7 6 7 7 6 7 6 16 0 0 0 0 0 0 0 17 7 7 6 7 7 6 6 6 7 6 16 0 0 26 0 
0 0 0 0 0 0 0 0 0 0 0 0 0 29 0 0 0 26 0 28 0 0 0 0 0 0 0 0 0 0 0 0 0 27 0 0 0 0 0 0 0 28 0 0 0 0 0 0 0 0 0 0 0 0 0 0 0 0 0 0 0 0 0 0 0 0 0 0 0 0 0 0 0 0 0 0 0 0 0 0 0 0 0 0 12 2 11 0 0 0 0 0 0 0 0 0 0 0 36 0 0 0 0 0 0 27 0 28 0 0 12 2 2 21 0 29 0 0 0 0 0 0 0 0 0 0 0 0 0 26 31 52 31 31 52 31 36 0 29 0 0 0 0 0 0 0 0 0 26 0 28 0 0 0 0 0 0 0 0 0 0 0 0 0 0 0 0 0 0 0 0 0 0 0 0 0 0 0 0 0 0 0 0 0 0 0 0 0 0 0 0 0 0 0 0 0 0 0 26 0 
0 7 7 7 6 6 6 6 6 7 7 7 7 16 0 0 0 27 0 29 0 0 0 0 0 0 0 0 0 0 0 0 0 17 6 6 6 6 6 6 6 16 0 0 0 0 0 0 0 0 0 0 0 0 0 0 0 0 0 0 0 0 0 0 0 0 0 12 1 1 1 1 2 1 1 11 0 0 0 0 0 0 0 0 27 0 29 0 0 0 0 0 0 0 0 0 0 0 0 0 0 0 0 0 0 27 0 29 0 0 0 0 31 31 0 28 0 0 0 0 0 0 0 0 0 0 0 0 0 26 0 42 47 51 47 31 0 47 29 0 0 0 0 0 0 0 0 0 27 0 28 0 0 0 0 0 0 0 0 0 0 0 0 0 0 0 0 0 0 0 0 0 0 0 0 0 0 0 0 0 0 0 0 0 0 0 0 0 0 0 0 0 0 0 0 0 0 0 27 0 
0 29 0 0 0 0 0 0 0 0 0 0 0 0 0 0 0 17 7 16 0 0 0 0 0 0 0 0 0 0 0 0 0 0 0 0 0 0 0 0 0 0 0 0 0 0 0 0 0 0 0 0 0 0 0 0 0 0 0 0 0 0 0 0 0 0 0 0 0 0 0 0 0 0 0 0 0 0 0 0 0 0 0 0 27 0 29 0 0 0 0 0 0 0 0 0 0 0 0 0 0 0 0 0 0 27 0 28 0 0 0 0 27 31 0 29 0 0 0 0 0 0 0 0 0 0 0 0 0 17 7 6 7 6 6 7 6 7 16 0 0 0 0 0 0 0 0 0 26 0 28 0 0 0 0 0 0 0 0 0 0 0 0 0 0 0 0 0 0 0 0 0 0 0 0 0 0 0 0 0 0 0 0 0 0 0 0 0 0 0 0 0 0 0 0 0 0 0 27 0 
0 28 0 0 0 0 0 0 0 0 0 0 0 0 0 0 0 0 0 0 0 0 0 0 0 0 0 0 0 0 0 0 0 0 0 0 0 0 0 0 0 0 0 0 0 0 0 0 0 0 0 0 0 0 0 0 0 0 0 0 0 0 0 0 0 0 0 0 0 0 0 0 0 0 0 0 0 0 0 0 0 0 0 0 26 0 29 0 0 0 0 0 0 0 0 0 0 0 0 0 0 0 0 0 0 26 0 29 0 0 0 0 17 7 6 16 0 0 0 0 0 0 0 0 0 0 0 0 0 0 0 0 0 0 0 0 0 0 0 0 0 0 0 0 0 0 0 0 26 0 29 0 0 0 0 0 0 0 0 0 0 0 0 0 0 0 0 0 0 0 0 0 0 0 0 0 0 0 0 0 0 0 0 0 0 0 0 0 0 0 0 0 0 0 0 0 0 0 27 0 
0 28 0 0 0 0 0 0 0 0 0 0 0 0 0 0 0 0 0 0 0 0 0 0 0 0 0 0 0 0 0 0 0 0 0 0 0 0 0 0 0 0 0 0 0 0 0 0 0 0 0 0 0 0 0 0 0 0 0 0 0 0 0 0 0 0 0 0 0 0 0 0 0 0 0 0 0 0 0 0 0 0 0 0 26 0 28 0 0 0 0 0 0 0 0 0 0 0 0 0 0 0 0 0 0 27 0 29 0 0 0 0 0 0 0 0 0 0 0 0 0 0 0 0 0 0 0 0 0 0 0 0 0 0 0 0 0 0 0 0 0 0 0 0 0 0 0 0 26 0 28 0 0 0 0 0 0 0 0 0 0 0 0 0 0 0 0 0 0 0 0 0 0 0 0 0 0 0 0 0 0 0 0 0 0 0 0 0 0 0 0 0 0 0 0 0 0 0 26 0 
0 24 1 2 1 2 1 2 1 2 1 2 1 2 1 2 1 2 1 2 1 2 1 2 1 2 1 2 1 2 1 2 1 2 1 2 1 2 1 2 1 2 1 2 1 1 1 2 1 2 1 2 1 2 1 2 1 2 1 2 1 2 1 2 1 2 1 2 1 2 1 2 1 2 1 2 1 2 1 2 1 2 1 2 26 0 24 1 2 2 1 2 1 1 1 2 1 1 1 2 2 1 2 1 1 21 0 24 1 1 2 1 1 1 1 2 2 2 2 2 1 1 2 1 2 2 1 1 2 2 2 1 2 2 1 1 2 1 1 1 1 2 1 2 2 1 1 2 2 1 1 1 1 2 2 1 1 2 1 2 1 1 1 2 2 1 2 2 1 2 1 2 2 2 1 2 2 2 1 2 1 2 1 1 1 2 2 2 1 1 1 2 2 2 1 1 2 1 21 0 
0 0 0 0 0 0 0 0 0 0 0 0 0 0 0 0 0 0 0 0 0 0 0 0 0 0 0 0 0 0 0 0 0 0 0 0 0 0 0 0 0 0 0 0 0 0 0 0 0 0 0 0 0 0 0 0 0 0 0 0 0 0 0 0 0 0 0 0 0 0 0 0 0 0 0 0 0 0 0 0 0 0 0 0 0 0 0 0 0 0 0 0 0 0 0 0 0 0 0 0 0 0 0 0 0 0 0 0 0 0 0 0 0 0 0 0 0 0 0 0 0 0 0 0 0 0 0 0 0 0 0 0 0 0 0 0 0 0 0 0 0 0 0 0 0 0 0 0 0 0 0 0 0 0 0 0 0 0 0 0 0 0 0 0 0 0 0 0 0 0 0 0 0 0 0 0 0 0 0 0 0 0 0 0 0 0 0 0 0 0 0 0 0 0 0 0 0 0 0 0

