TILEMAP
250 15 								-- Size of tile map in tiles
16 16 								-- Tile size & block size
images/sea_tiles.png 						-- Tilesheet
16 24  								-- Number of tiles in tilesheet
0 0 0 0 0 0 0 0 0 0 0 0 0 0 0 0 0 0 0 0 0 0 0 0 0 0 0 0 0 0 0 0 0 0 0 0 0 0 0 0 0 0 0 0 0 0 0 0 0 0 0 0 0 0 0 0 0 0 0 0 0 0 0 0 0 0 0 34 34 34 0 0 0 0 0 0 0 0 0 0 0 0 0 0 0 0 0 0 0 0 0 0 0 0 0 0 0 0 0 0 0 0 0 0 0 0 0 0 0 0 0 0 0 0 0 0 0 0 0 0 51 51 51 51 51 51 51 51 51 51 51 51 123 123 123 123 123 123 123 123 123 123 123 123 51 123 123 123 123 123 123 123 123 18 18 18 18 18 33 33 18 18 18 51 51 51 18 34 34 18 18 50 50 50 50 50 50 50 50 50 34 34 34 34 34 0 0 0 0 0 0 0 0 0 0 0 0 0 0 0 0 0 0 0 0 0 0 0 0 0 0 0 0 0 36 36 1 1 1 2 17 17 17 17 17 17 1 1 2 3 1 1 1 2 3 4 4 4 4 4 1 1 1 1 1 1 1 1 1 2 
0 0 0 0 0 0 0 0 0 0 0 0 0 0 0 0 0 0 0 0 0 0 0 0 0 0 0 0 0 0 0 0 0 0 0 0 0 0 0 0 0 0 0 0 0 0 0 0 0 0 0 0 0 0 0 0 0 0 0 0 0 0 0 0 0 0 0 0 0 0 0 0 0 0 0 0 0 0 0 0 0 0 0 0 0 0 0 0 0 0 0 0 0 0 0 0 0 0 0 0 0 0 0 0 0 0 0 0 0 0 0 0 0 0 0 0 0 0 0 0 0 51 51 51 51 51 51 51 51 51 51 51 123 123 123 123 51 51 0 0 0 0 0 51 51 50 36 36 35 35 0 0 0 0 51 51 34 50 0 0 0 35 50 0 0 0 0 0 51 34 18 50 50 50 50 50 50 50 50 50 34 34 34 0 0 0 0 0 0 0 0 0 0 0 0 0 0 0 0 0 0 0 0 0 0 0 0 0 0 0 0 0 0 0 0 0 1 2 1 2 33 33 33 33 33 33 17 1 2 1 17 17 1 2 3 4 20 20 20 20 53 53 0 0 0 0 0 0 0 0 
0 0 0 0 0 0 0 0 0 0 0 0 0 0 0 0 0 0 0 0 0 0 0 0 0 0 0 0 0 0 0 0 0 0 0 0 0 0 0 0 0 0 0 0 0 0 0 0 0 0 0 0 0 0 0 0 0 0 0 0 0 0 0 0 0 0 0 0 0 0 0 0 0 0 0 0 0 0 0 0 0 0 0 0 0 0 0 0 0 0 0 0 0 0 0 0 0 0 0 0 0 34 34 34 34 34 34 50 50 50 50 0 0 0 0 0 0 0 0 0 0 0 51 51 51 51 51 51 51 51 51 51 51 123 123 123 0 0 0 0 0 0 0 0 0 50 36 36 0 0 0 0 0 0 50 51 0 0 0 0 0 0 35 0 0 0 0 0 0 18 18 50 50 50 50 50 50 50 50 50 34 0 0 0 0 0 0 0 0 0 0 0 0 0 0 0 0 0 0 0 0 0 0 0 0 0 0 0 0 0 0 0 0 0 0 0 1 2 1 2 49 49 49 49 1 2 3 4 4 17 33 33 1 2 3 4 36 36 36 36 0 0 0 0 0 0 0 0 0 0 
0 0 0 0 0 0 0 0 0 0 0 0 0 0 0 0 0 0 0 0 0 0 0 0 0 0 0 0 0 0 0 0 0 0 0 0 0 0 0 0 0 0 0 0 0 0 0 0 0 0 0 0 0 0 0 0 0 0 0 0 0 0 0 0 0 0 34 34 34 34 34 0 0 0 0 0 0 0 0 0 0 0 0 0 0 0 0 0 0 0 0 0 0 0 0 0 0 0 0 0 0 34 34 34 34 34 34 34 34 50 50 0 0 0 0 0 0 0 0 0 0 0 0 51 51 51 51 51 51 51 51 51 51 123 123 123 0 0 0 0 0 0 0 0 0 50 36 36 0 0 0 0 0 0 50 51 0 0 0 0 0 0 0 0 0 0 0 0 0 18 18 34 0 0 0 0 0 0 0 0 0 0 0 0 0 0 0 0 0 0 0 0 0 0 0 0 0 0 0 0 0 0 0 0 0 0 0 0 0 0 0 0 50 36 36 36 1 2 1 2 49 50 51 1 2 3 4 4 20 33 49 49 17 18 19 20 52 52 52 52 0 0 0 0 0 0 0 0 0 0 
0 0 0 0 0 0 0 0 0 0 0 0 0 0 0 0 0 0 0 0 0 0 0 0 0 0 0 0 0 0 0 0 0 0 0 0 0 0 0 0 0 0 0 0 0 0 0 0 0 0 0 0 0 0 0 0 0 0 0 0 0 0 0 0 0 0 0 0 0 0 0 0 0 0 0 0 0 0 0 0 0 0 0 0 0 0 0 0 0 0 0 0 0 0 0 0 0 0 0 0 0 34 34 34 34 34 34 34 34 34 34 0 0 0 0 0 0 0 0 0 0 0 0 0 51 51 51 51 51 51 51 51 123 123 123 123 51 51 51 0 0 0 67 67 67 67 36 36 36 36 36 36 0 0 51 51 0 0 0 0 33 33 0 0 0 35 35 35 35 18 18 34 0 0 0 0 0 0 0 0 0 0 0 0 0 0 0 0 0 0 0 0 0 0 0 0 0 0 0 0 0 0 0 0 0 0 0 0 0 0 0 0 0 0 0 0 1 2 1 2 50 49 1 2 3 4 4 20 36 49 50 51 33 34 35 36 49 50 51 52 53 53 53 53 53 53 0 0 0 0 
0 0 0 0 0 0 0 0 0 0 0 0 0 0 0 0 0 0 0 0 0 0 0 0 0 0 0 0 0 0 0 0 0 0 0 0 0 0 0 0 0 0 0 0 0 0 0 0 0 0 0 0 0 0 0 0 0 0 0 0 0 0 0 0 0 0 0 0 0 0 0 0 0 0 0 0 0 0 0 0 0 0 0 0 0 0 0 0 0 0 0 0 0 0 0 0 0 0 18 67 67 33 33 33 33 33 33 33 33 123 123 33 33 0 0 0 0 0 0 0 0 0 0 0 0 51 51 51 51 51 51 51 123 123 123 123 0 0 0 0 0 0 0 0 0 0 0 0 0 0 0 36 0 0 0 0 34 33 0 0 0 0 0 0 0 0 0 0 0 18 18 18 19 19 19 19 19 35 35 35 35 35 35 35 35 35 35 35 35 35 35 35 35 35 35 35 35 35 17 18 18 18 18 18 0 0 0 0 0 0 0 0 0 0 0 0 1 2 1 2 50 1 2 3 4 4 20 36 52 49 50 51 49 50 51 52 50 51 52 50 0 0 0 0 0 0 0 0 0 0 
0 0 0 0 0 0 0 0 0 0 0 0 0 0 0 0 0 0 0 0 0 0 0 0 0 0 0 0 0 0 0 0 0 0 0 0 0 0 0 0 0 0 0 0 0 0 0 0 0 0 0 0 0 0 0 0 0 0 0 0 34 51 51 51 51 51 51 51 51 51 51 51 51 51 51 51 51 0 0 0 0 0 0 0 0 0 0 0 0 0 0 0 0 0 0 0 0 0 34 67 67 33 33 33 33 33 33 33 33 123 123 33 33 33 33 0 0 0 0 0 0 0 0 0 0 0 51 51 51 51 51 51 123 123 123 123 0 0 0 0 0 0 0 0 0 0 0 0 0 0 0 36 0 0 0 0 34 50 0 0 0 0 0 0 50 0 0 0 0 19 18 18 18 19 19 19 19 0 0 0 0 0 0 0 0 0 0 0 0 0 0 0 0 0 0 0 0 0 0 18 34 34 34 34 0 0 0 0 0 0 50 50 50 50 50 50 1 2 1 2 50 1 2 3 4 20 1 1 1 49 50 51 52 49 49 49 50 51 52 50 0 0 0 0 0 0 0 0 0 0 
0 0 0 0 0 0 0 0 0 0 0 0 0 0 0 0 0 0 0 0 0 0 0 0 0 0 0 0 0 0 0 0 0 0 0 17 17 17 17 17 0 0 0 0 0 0 0 0 0 0 0 0 0 0 0 0 0 0 0 0 34 0 0 0 0 0 0 0 35 0 0 0 0 0 0 0 51 0 0 0 0 0 0 0 0 0 0 0 0 0 0 0 0 0 0 0 0 0 34 0 0 0 0 68 68 68 0 0 0 0 33 33 33 33 33 33 33 0 0 0 0 0 0 0 0 0 0 51 51 51 51 51 123 123 123 123 33 34 35 36 37 38 51 51 51 51 51 50 33 33 33 33 33 33 33 33 34 35 0 0 0 0 0 0 51 0 0 0 0 19 19 18 18 18 18 18 19 0 0 0 0 0 0 0 0 0 0 0 0 0 0 0 0 0 0 0 0 0 0 53 17 17 18 17 17 18 0 0 0 0 0 0 0 0 0 0 1 2 1 2 50 1 2 3 4 36 17 17 1 2 49 50 51 52 36 20 4 4 20 50 0 0 0 0 0 0 0 0 0 0 
0 0 0 0 0 0 0 0 0 0 0 0 0 0 0 0 0 0 0 0 0 0 0 0 0 0 0 0 0 0 0 0 0 0 17 17 17 17 17 17 17 0 0 0 0 0 0 0 0 0 0 0 0 0 0 0 0 0 0 0 34 0 0 0 0 0 0 0 35 0 0 0 0 0 0 0 51 0 0 0 0 0 0 0 0 0 0 0 0 0 0 0 0 0 0 0 0 0 34 0 0 0 0 0 0 0 0 0 0 0 33 33 33 123 123 33 123 123 33 0 0 0 0 0 0 0 0 0 51 51 51 51 123 123 123 33 33 33 33 33 33 33 35 35 35 35 35 35 35 0 0 0 0 0 34 0 0 35 36 0 0 0 0 35 51 0 0 51 34 19 19 33 33 33 33 33 33 0 0 0 0 0 0 0 0 0 0 0 0 0 0 0 0 0 0 0 0 0 0 18 18 18 34 33 17 17 0 0 0 0 0 0 0 0 0 0 1 2 1 2 50 1 2 3 4 1 33 33 1 1 49 50 51 52 52 36 20 20 36 50 0 0 0 0 53 53 53 53 53 53 
123 123 0 0 0 0 0 0 0 0 0 0 0 0 0 0 0 0 0 0 0 0 0 0 0 0 0 0 0 0 0 0 0 17 17 17 17 17 17 17 17 17 0 0 0 0 0 0 0 0 0 0 0 0 0 0 0 0 0 0 34 0 0 0 0 0 0 35 35 35 0 0 0 0 0 0 33 0 0 0 0 0 0 0 0 0 0 0 0 0 0 0 0 0 0 0 0 0 34 0 0 0 0 0 0 0 0 0 0 0 123 33 33 123 33 33 123 33 33 33 123 0 0 0 0 0 0 0 0 0 51 51 123 123 123 123 34 34 34 34 34 34 0 0 0 0 0 0 0 0 0 0 0 0 34 0 0 50 34 34 34 34 34 51 51 0 0 0 0 34 18 33 33 33 33 33 33 0 0 0 0 0 0 0 0 0 0 0 0 0 0 0 0 0 0 0 0 0 0 0 0 0 18 33 17 33 0 0 0 0 0 0 0 0 0 0 1 2 1 1 2 1 2 3 4 17 49 49 17 1 2 49 50 51 52 52 36 36 52 50 0 0 0 0 0 0 0 0 0 0 
123 123 0 0 0 0 0 0 0 0 0 0 0 0 0 0 0 0 0 0 0 0 0 0 0 0 0 0 0 0 0 0 17 17 17 17 17 17 17 17 17 17 17 0 0 0 0 0 0 0 0 0 0 0 0 0 0 0 0 0 34 0 0 0 0 0 0 0 0 0 0 0 0 0 0 0 33 0 0 0 0 0 0 0 0 0 0 0 0 0 0 0 0 0 0 0 0 0 34 0 0 0 68 68 68 68 68 0 0 0 123 123 33 33 33 123 33 33 123 33 123 33 33 0 0 0 0 0 0 0 0 51 123 123 123 123 34 34 34 34 34 34 0 0 0 0 0 0 0 0 0 0 0 0 34 0 0 50 49 0 0 0 0 0 51 0 0 0 0 34 34 33 33 33 33 33 0 0 0 0 0 0 0 0 0 0 0 0 0 0 0 0 0 0 0 0 0 0 0 0 0 0 0 18 33 33 17 17 18 0 0 0 0 0 0 0 1 2 1 2 2 1 2 3 1 33 49 50 1 1 1 1 49 50 51 52 52 52 52 50 0 0 0 0 0 0 0 0 0 0 
123 123 123 123 123 123 123 123 123 123 123 123 123 123 123 123 123 123 123 123 123 123 123 68 68 68 68 68 68 68 68 17 17 17 17 17 17 17 17 17 17 17 17 17 0 0 0 0 0 0 0 0 0 0 0 0 0 0 0 0 34 0 0 0 0 0 0 0 0 0 0 0 0 0 0 0 33 0 0 0 0 0 0 0 0 0 0 0 0 0 0 0 0 0 0 0 18 67 33 0 0 0 0 0 0 0 0 0 0 0 123 123 123 123 33 33 123 123 33 33 33 33 123 123 123 0 0 0 0 0 0 51 123 123 123 123 51 51 51 51 51 34 50 50 33 33 33 33 33 33 33 33 0 0 34 0 0 50 0 0 0 0 0 0 51 51 51 34 18 18 18 33 33 33 33 0 0 0 0 0 0 0 0 0 0 0 0 0 0 0 0 0 0 0 0 0 0 0 0 0 0 0 0 34 34 35 33 17 17 18 0 0 0 0 0 0 1 2 1 2 2 1 1 1 17 49 49 50 17 17 17 17 17 17 17 49 50 51 52 50 0 0 0 0 0 0 0 0 0 0 
123 123 123 123 123 123 123 123 123 123 123 123 123 123 123 123 123 123 123 123 123 123 123 17 68 68 68 68 68 68 68 17 17 17 17 17 17 17 17 17 17 17 17 17 17 0 0 0 0 0 0 0 0 0 0 0 0 0 33 33 33 0 0 0 0 0 35 35 35 35 35 0 0 0 0 0 33 33 33 0 0 0 0 0 0 0 0 0 0 0 0 0 0 0 0 0 34 67 33 0 0 0 0 0 0 0 0 0 0 0 123 123 123 123 33 33 123 123 33 33 33 33 123 123 123 123 123 0 0 0 0 0 123 123 123 123 0 0 0 0 0 34 0 0 0 0 0 0 0 0 0 50 0 0 0 0 0 50 0 0 0 0 0 0 0 0 0 34 34 34 34 34 0 0 0 0 0 0 0 0 0 0 0 0 0 0 0 0 0 0 0 0 0 0 0 0 0 0 0 0 0 0 0 33 34 17 18 18 17 17 18 0 0 0 0 0 1 2 1 2 2 17 17 17 33 49 50 51 33 33 33 33 33 33 33 49 50 51 52 50 50 50 50 50 50 50 50 0 0 0 
123 123 123 123 123 123 123 123 123 123 123 123 123 123 123 123 123 123 123 123 123 123 123 17 17 68 68 68 68 68 17 17 17 17 17 17 17 17 17 17 17 17 17 17 17 17 0 0 0 0 0 0 0 0 0 0 0 0 33 33 33 0 0 0 0 0 50 50 50 50 50 0 0 0 0 0 33 33 33 0 0 0 0 0 0 0 0 0 0 0 0 0 0 18 18 18 18 18 33 0 0 0 0 0 0 0 0 0 0 0 123 123 123 123 123 123 123 123 123 123 123 123 123 123 123 123 123 123 123 0 0 0 123 123 123 123 0 0 0 0 0 34 0 0 0 0 0 0 0 0 0 50 0 0 0 0 0 50 50 67 49 0 0 0 0 0 0 18 18 18 34 34 0 0 0 0 0 0 0 0 0 0 0 0 0 0 0 0 0 0 0 0 0 0 0 0 0 0 0 0 0 0 0 33 34 33 34 34 18 18 17 18 0 0 0 0 1 1 1 2 50 33 33 33 49 49 50 51 49 49 49 49 49 49 49 49 50 51 52 50 0 0 0 0 0 0 0 0 0 0 
123 123 123 123 123 123 123 123 123 123 123 123 123 123 123 123 123 123 123 123 123 123 123 17 17 17 17 17 17 17 17 17 17 17 17 17 17 17 17 17 17 17 17 17 17 17 33 33 33 33 33 18 18 18 18 19 18 18 18 18 18 18 18 18 18 18 18 18 18 18 18 18 18 18 18 18 18 18 18 18 18 18 18 18 52 52 52 18 18 18 18 19 18 18 19 19 19 18 19 19 19 19 19 19 19 19 19 19 19 19 123 123 123 123 123 123 123 123 123 123 123 123 123 123 123 123 123 123 123 123 123 123 123 123 123 123 123 123 123 123 123 123 123 123 123 123 123 123 18 18 18 18 18 18 18 18 18 18 18 18 18 18 34 34 18 18 123 34 34 34 34 34 34 34 34 34 34 34 34 34 34 34 34 34 34 34 35 36 34 35 36 37 37 37 37 37 37 34 34 34 34 35 36 37 35 35 33 34 34 34 33 34 35 35 35 35 35 2 2 2 2 49 49 49 49 50 51 52 50 50 50 50 50 50 50 50 50 50 50 50 1 1 1 1 1 1 1 1 1 2
