TILEMAP
250 15 								-- Size of tile map in tiles
16 16 								-- Tile size & block size
images/sea_tiles.png 						-- Tilesheet
16 24  								-- Number of tiles in tilesheet
0 0 0 0 0 0 0 0 0 0 0 0 0 0 0 0 0 0 0 0 0 0 0 0 0 0 0 0 0 0 0 0 0 0 0 0 0 0 0 0 0 0 0 0 0 0 0 0 0 0 0 0 0 0 0 0 0 0 0 0 0 0 0 0 0 0 0 203 204 205 0 0 0 0 0 0 0 0 0 0 0 0 0 0 0 0 0 0 0 0 0 0 0 0 0 0 0 0 0 0 0 0 0 0 0 0 0 0 0 0 0 0 0 0 0 0 0 0 0 0 343 325 326 325 326 325 326 325 326 325 326 325 326 325 325 326 325 325 326 325 326 325 325 326 325 326 325 326 325 326 325 326 326 325 326 325 326 325 325 326 325 326 325 326 325 326 325 325 326 341 342 342 341 342 342 341 341 342 342 341 342 341 342 357 358 0 0 0 0 0 0 0 0 0 0 0 0 0 0 0 0 0 0 0 0 0 0 0 0 0 0 0 0 0 50 50 50 50 50 50 50 50 50 50 50 50 50 50 50 50 50 50 50 50 50 50 50 50 50 50 34 34 34 34 34 34 34 34 34 34 
0 0 0 0 0 0 0 0 0 0 0 0 0 0 0 0 0 0 0 0 0 0 0 0 0 0 0 0 0 0 0 0 0 0 0 0 0 0 0 0 0 0 0 0 0 0 0 0 0 0 0 0 0 0 0 0 0 0 0 0 0 0 0 0 0 0 0 0 0 0 0 0 0 0 0 0 0 0 0 0 0 0 0 0 0 0 0 0 0 0 0 0 0 0 0 0 0 0 0 0 0 0 0 0 0 0 0 0 0 0 0 0 0 0 0 0 0 0 0 0 0 341 342 341 342 341 342 341 342 341 342 341 342 341 342 342 343 343 373 373 373 374 375 338 339 342 343 343 338 339 373 373 374 375 338 339 339 339 373 374 375 342 342 373 374 373 374 375 325 357 358 358 357 358 358 357 357 358 358 357 358 357 358 0 0 0 0 0 0 0 0 0 0 0 0 0 0 0 0 0 0 0 0 0 0 0 0 0 0 0 0 0 0 0 0 0 50 50 51 50 50 50 50 50 34 50 50 51 50 50 50 50 50 50 51 50 50 50 50 50 34 34 0 0 0 0 0 0 0 0 
0 0 0 0 0 0 0 0 0 0 0 0 0 0 0 0 0 0 0 0 0 0 0 0 0 0 0 0 0 0 0 0 0 0 0 0 0 0 0 0 0 0 0 0 0 0 0 0 0 0 0 0 0 0 0 0 0 0 0 0 0 0 0 0 0 0 0 0 0 0 0 0 0 0 0 0 0 0 0 0 0 0 0 0 0 0 0 0 0 0 0 0 0 0 0 0 0 0 0 0 0 193 194 194 194 194 194 194 194 194 194 0 0 0 0 0 0 0 0 0 0 0 341 342 342 341 342 341 341 342 341 341 341 341 342 342 0 0 0 0 0 0 0 0 0 358 359 343 0 0 0 0 0 0 338 339 0 0 0 0 0 0 358 0 0 0 0 0 0 357 357 358 357 357 358 357 358 358 357 358 358 0 0 0 0 0 0 0 0 0 0 0 0 0 0 0 0 0 0 0 0 0 0 0 0 0 0 0 0 0 0 0 1 2 3 4 50 50 50 50 51 50 50 50 50 50 34 34 50 50 50 50 50 50 50 50 50 50 50 50 0 0 0 0 0 0 0 0 0 0 
0 0 0 0 0 0 0 0 0 0 0 0 0 0 0 0 0 0 0 0 0 0 0 0 0 0 0 0 0 0 0 0 0 0 0 0 0 0 0 0 0 0 0 0 0 0 0 0 0 0 0 0 0 0 0 0 0 0 0 0 0 0 0 0 0 0 201 202 203 204 205 0 0 0 0 0 0 0 0 0 0 0 0 0 0 0 0 0 0 0 0 0 0 0 0 0 0 0 0 0 0 209 243 259 243 259 259 243 259 337 243 0 0 0 0 0 0 0 0 0 0 0 0 341 342 341 342 341 341 342 341 342 342 341 342 342 0 0 0 0 0 0 0 0 0 342 358 359 0 0 0 0 0 0 338 339 0 0 0 0 0 0 358 0 0 0 0 0 0 341 342 358 0 0 0 0 0 0 0 0 0 0 0 0 0 0 0 0 0 0 0 0 0 0 0 0 0 0 0 0 0 0 0 0 0 0 0 0 0 0 0 0 17 18 19 20 50 34 50 51 50 50 50 50 50 50 50 50 50 50 50 50 50 50 50 50 50 50 50 50 1 1 1 2 3 4 0 0 0 0 
0 8 0 0 0 0 0 0 0 0 0 0 0 0 0 0 0 0 0 0 0 0 0 0 0 0 0 0 0 0 0 0 0 0 0 0 0 0 0 0 0 0 0 0 0 0 0 0 0 0 0 0 0 0 0 0 0 0 0 0 0 0 0 0 0 0 220 220 220 220 221 0 0 0 0 0 0 0 0 0 0 0 0 0 0 0 0 0 0 0 0 0 0 0 0 0 0 0 0 0 193 194 226 338 226 226 226 226 226 226 205 206 0 0 0 0 0 0 0 0 0 0 0 0 341 342 341 342 342 341 342 342 341 341 341 342 343 343 343 0 0 0 338 338 339 358 338 339 338 339 338 339 0 0 338 339 0 0 0 0 342 342 0 0 0 326 325 326 326 326 358 358 0 0 0 0 0 0 0 0 0 0 0 0 0 0 0 0 0 0 0 0 0 0 0 0 0 0 0 0 0 0 0 0 0 0 0 0 0 0 0 0 0 0 0 0 50 34 50 51 50 50 35 50 35 50 50 50 50 50 34 34 34 50 50 50 50 50 50 50 17 17 17 18 19 20 0 0 0 0 
23 24 25 0 0 0 0 0 0 0 0 0 0 0 0 0 0 0 0 0 0 0 0 0 0 0 0 0 0 0 0 0 0 0 0 0 0 0 0 0 0 0 0 0 0 0 0 0 0 0 0 0 0 0 0 0 0 0 0 0 0 0 0 0 0 0 0 0 0 0 0 0 0 0 0 0 0 0 0 0 0 0 0 0 0 0 0 0 0 0 0 0 0 0 0 0 0 0 193 194 209 210 201 342 341 342 341 226 226 226 203 204 205 206 0 0 0 0 0 0 0 0 0 0 0 341 342 341 342 341 341 342 341 341 342 342 0 0 0 0 0 0 0 0 0 0 0 0 373 374 375 343 0 0 0 0 343 343 0 0 373 374 0 0 0 342 0 0 0 341 342 341 341 337 338 342 342 341 341 342 342 342 342 341 342 342 341 342 342 342 342 342 341 342 342 342 342 341 342 342 341 342 243 244 0 0 0 8 0 0 1 2 1 2 3 4 50 34 50 50 50 50 50 50 50 50 50 50 35 51 50 50 50 50 50 50 50 50 50 50 0 0 0 0 0 0 0 0 0 0 
39 40 41 0 0 0 0 0 0 0 0 0 0 0 0 0 0 0 0 0 0 0 0 0 0 0 0 0 0 0 0 0 0 0 0 0 0 0 0 0 0 0 0 0 0 0 0 0 0 0 0 0 0 0 0 0 0 0 0 0 228 201 202 203 204 205 201 202 203 204 201 202 203 204 205 205 209 0 0 0 0 0 0 0 0 0 0 0 0 0 0 0 0 0 0 0 0 0 262 204 205 204 205 358 357 358 204 205 204 205 227 228 227 228 205 206 0 0 0 0 0 0 0 0 0 0 341 342 341 342 341 341 342 341 342 342 0 0 0 0 0 0 0 0 0 0 0 0 0 0 0 359 0 0 0 0 343 359 0 0 0 0 0 0 343 0 0 0 0 337 338 338 357 337 338 342 358 373 373 374 373 374 375 375 373 374 375 373 373 374 375 374 375 375 373 373 374 375 374 343 341 342 259 260 0 0 23 24 25 0 17 18 17 18 19 20 50 34 50 50 50 50 50 50 34 50 50 50 50 34 50 50 50 50 50 50 50 50 50 50 0 0 0 0 0 0 0 0 0 0 
0 56 0 0 0 0 0 0 0 0 0 0 0 0 0 0 0 0 0 0 0 0 0 0 0 0 0 0 0 0 0 0 0 0 158 174 174 174 174 191 159 0 0 0 0 0 0 0 0 0 0 0 0 0 0 0 0 0 0 0 235 220 220 221 220 221 220 221 259 220 221 220 220 220 220 221 209 0 0 0 0 0 0 0 0 0 0 0 0 0 0 0 0 0 0 0 0 0 262 220 221 220 221 204 204 205 220 221 220 221 243 244 243 227 227 228 205 206 0 0 0 0 0 0 0 0 0 341 342 341 341 341 342 342 341 342 342 342 342 342 343 342 343 342 342 343 342 343 343 338 339 338 339 339 338 339 359 359 0 0 0 0 0 0 343 0 0 0 0 341 342 337 338 342 358 358 358 0 0 0 0 0 0 0 0 0 0 0 0 0 0 0 0 0 0 0 0 0 0 343 343 343 243 243 243 244 39 40 41 0 0 0 0 0 0 0 50 50 50 50 50 50 50 51 35 50 50 34 34 50 50 50 50 50 50 50 50 50 50 50 0 0 0 0 1 2 3 4 2 3 
3 4 0 0 0 0 0 0 0 0 0 0 0 0 0 0 0 0 0 0 0 0 0 0 0 0 0 0 0 153 154 0 0 158 174 190 190 190 190 191 191 159 0 0 0 0 0 0 0 0 0 0 0 0 0 0 0 0 0 0 235 0 0 0 0 0 0 0 261 0 0 0 0 0 0 0 209 0 0 0 0 0 0 0 0 0 0 0 0 0 0 0 0 0 0 0 0 0 247 0 0 0 0 220 220 221 0 0 0 0 201 202 226 243 243 227 227 228 205 206 0 0 0 0 0 0 0 0 341 341 342 341 341 341 342 342 343 342 343 358 342 358 359 358 358 359 358 359 359 373 374 373 374 375 343 0 0 342 343 0 0 0 0 325 342 0 0 325 326 357 337 338 337 337 338 341 342 0 0 0 0 0 0 0 0 0 0 0 0 0 0 0 0 0 0 0 0 0 0 359 359 359 243 244 243 244 0 56 0 0 0 0 0 0 0 0 50 50 50 50 51 50 50 50 50 50 50 50 50 50 50 50 50 50 34 50 50 50 50 50 0 0 0 0 17 18 19 20 18 19 
17 18 0 0 0 0 0 0 0 0 0 0 0 0 0 0 0 0 0 0 0 0 0 0 0 0 0 0 0 169 170 171 157 123 190 189 190 189 189 189 190 191 159 0 0 0 0 0 0 0 0 0 0 0 0 0 0 0 0 0 235 0 0 0 0 0 0 204 204 205 0 0 0 0 0 0 209 0 0 0 0 0 0 0 0 0 0 0 0 0 0 0 0 0 0 0 0 0 247 0 0 0 0 0 0 0 0 0 0 0 201 202 242 242 226 243 243 244 227 228 205 206 0 0 0 0 0 0 0 0 341 342 341 342 341 358 342 358 359 343 358 359 0 0 0 0 0 0 0 0 0 0 0 0 343 0 0 359 342 325 326 342 326 326 343 0 0 0 0 337 338 337 338 357 358 357 358 0 0 0 0 0 0 0 0 0 0 0 0 0 0 0 0 0 0 0 0 0 0 373 374 375 259 260 243 244 0 72 0 0 0 0 0 0 0 0 50 50 50 50 50 34 50 50 50 50 34 50 50 50 50 50 50 51 50 50 50 50 50 50 0 0 0 0 0 0 0 0 0 0 
33 34 5 2 3 4 5 1 2 1 2 3 4 5 6 6 6 2 3 2 3 4 2 3 4 2 3 4 38 4 4 4 123 191 190 191 189 189 190 189 190 191 175 159 0 0 0 0 0 0 0 0 0 0 0 0 0 0 0 0 235 0 0 0 0 0 0 221 221 221 0 0 0 0 0 0 209 0 0 0 0 0 0 0 0 0 0 0 0 0 0 0 0 0 0 0 0 320 262 0 0 0 204 204 205 204 205 0 0 0 201 202 226 243 259 260 244 243 243 227 228 228 205 206 0 0 0 0 0 0 0 341 342 341 342 342 358 358 342 343 342 343 0 0 0 0 0 0 0 0 0 0 0 0 343 0 0 359 359 373 374 375 375 375 359 0 0 0 0 357 337 338 338 337 338 358 0 0 0 0 0 0 0 0 0 0 0 0 0 0 0 0 0 0 0 0 0 0 0 0 0 0 373 243 243 244 243 243 244 0 0 0 0 0 0 0 50 50 35 50 50 50 50 50 50 50 50 34 50 50 50 50 35 50 50 50 50 50 50 50 0 0 0 0 0 0 0 0 0 0 
33 34 50 18 18 18 19 20 18 18 18 19 20 18 18 18 18 18 18 18 18 18 20 17 18 17 18 18 54 108 139 139 191 189 189 189 189 189 190 191 190 191 139 175 159 0 0 0 0 0 0 0 0 0 0 0 0 0 0 320 235 0 0 0 0 0 0 0 0 0 0 0 0 0 0 0 209 0 0 0 0 0 0 0 0 0 0 0 0 0 0 0 0 0 0 0 359 359 247 0 0 0 220 220 221 220 221 0 0 0 201 202 242 243 243 244 244 259 260 243 244 227 227 228 205 206 0 0 0 0 0 341 341 341 341 343 358 359 358 359 358 359 342 341 342 341 341 342 341 342 341 343 0 0 359 0 0 342 0 0 0 0 0 0 325 325 326 326 325 337 338 357 337 338 358 0 0 0 0 0 0 0 0 0 0 0 0 0 0 0 0 0 0 0 0 0 0 0 0 0 0 0 0 243 243 243 243 259 243 244 0 0 0 0 0 0 50 50 50 34 50 50 50 51 35 50 50 50 50 50 50 50 50 50 50 50 50 50 50 50 1 1 1 1 2 3 4 0 0 0 
33 34 34 34 34 34 35 36 34 34 34 35 36 34 34 34 34 34 34 34 34 34 36 33 34 34 34 34 54 139 123 139 189 190 191 189 190 189 190 191 190 191 139 139 175 159 0 0 0 0 0 0 0 0 0 0 0 0 219 235 235 0 0 0 0 0 196 197 198 198 199 0 0 0 0 0 209 219 219 0 0 0 0 0 0 0 0 0 0 0 0 0 0 0 0 0 201 202 247 0 0 0 0 0 0 0 0 0 0 0 201 202 226 243 243 244 243 243 244 244 243 243 227 228 227 228 205 206 0 0 0 0 341 342 342 343 0 373 374 375 0 343 0 373 373 373 373 373 374 375 0 359 0 0 0 0 0 359 0 0 0 0 0 0 0 0 0 341 341 357 358 341 0 0 0 0 0 0 0 0 0 0 0 0 0 0 0 0 0 0 0 0 0 0 0 0 0 0 0 0 0 0 0 243 259 243 259 260 243 243 244 0 0 0 0 0 50 50 50 50 50 50 50 34 51 50 50 50 50 51 50 34 50 50 50 51 50 50 50 50 17 17 17 17 18 19 20 0 0 0 
33 34 34 34 34 34 51 52 34 34 34 51 52 34 34 34 34 34 34 34 34 51 52 34 34 50 34 34 54 139 139 139 190 191 191 189 190 189 190 191 190 191 139 139 139 175 159 0 0 0 0 0 0 0 0 0 0 320 235 235 235 0 236 237 0 0 212 213 214 214 215 0 236 237 0 0 209 235 235 0 0 0 0 0 0 0 0 0 0 0 0 0 320 201 202 358 201 202 262 0 0 0 0 0 0 0 0 0 0 320 201 202 242 243 259 260 244 244 259 260 244 244 244 244 243 244 227 228 205 206 0 0 341 342 341 343 0 0 0 0 0 343 0 0 0 0 0 0 0 0 0 359 0 0 0 0 0 325 325 325 326 0 0 0 0 0 0 325 325 337 338 341 0 0 0 0 0 0 0 0 0 0 0 0 0 0 0 0 0 0 0 0 0 0 0 0 0 0 0 0 0 0 0 243 243 259 243 244 259 259 243 244 1 2 3 4 50 34 50 50 50 35 50 34 50 50 50 50 50 34 50 50 50 50 50 50 50 50 50 50 0 0 0 0 0 0 0 0 0 0 
49 50 50 50 50 50 50 50 50 50 50 50 50 50 50 50 34 50 50 50 50 50 50 50 50 50 50 50 54 139 139 189 190 191 191 191 191 191 189 190 191 191 191 191 191 191 191 191 190 190 190 190 190 190 190 190 190 190 190 201 202 203 204 205 201 202 203 201 202 203 204 205 201 202 203 204 205 242 259 260 242 259 260 242 259 260 242 259 260 242 360 259 360 201 202 201 201 202 201 202 201 202 201 202 201 202 202 201 202 202 201 201 202 259 260 243 243 259 260 259 259 259 260 244 244 244 243 244 227 228 259 260 259 341 342 343 341 341 342 341 341 341 341 342 342 341 341 342 341 341 341 341 342 341 341 342 341 341 342 341 341 341 341 341 341 342 325 342 326 357 358 337 338 337 337 337 337 337 337 337 337 337 337 337 337 337 337 337 337 337 337 337 337 337 337 337 337 337 337 337 337 337 338 259 259 260 259 260 260 259 259 260 17 18 19 20 34 50 50 50 50 50 50 50 50 50 50 50 50 50 50 50 50 50 50 50 50 50 50 50 18 18 18 18 19 20 20 18 19 20
